W W W W W W W W W W W W W W W W W W W W W W W W W W W W W W
W W W W W E E E E I E E E E W W E E E E E W W W W W W W W W
W W W E E E W W W W W W W E W W E W W W E W W W W W W W W W
W W W W W W W W W W W W W E E E E W W W I E E E C W W W W W
W W W W W W W W W W W W W W W W W W W W E W W W I W W E E E
W E E E C E I E E E W W W W W W W W W W E E E W E W W E W W
W I W W W W W W W E W W W W W W E E E W W W E W E W W E W W
W E W W W W W W W E W W W W W W E W E W W W C W C E E I W W
W E W W W W W W W E W W W W W W E W E W W W E W W W W W W W
W E I E C E E W W E E E W W W W E W E W W W E W W W W W W W
W W W W W W E W W W W C W W W W E W E W E E E W W W W W W W
W W W W E E E W W W W I E C E E E W E W E W W W W W W W W W
W W W W E W W W W W W W W E W W W W E W E W W W W W W W W W
W W W W E W W W W W W W W E W W W W E W E W W W W W W W W W
W W W W E E E I E E W W W C W W E E I W E E E E E E W W W W
W W W W W W W W W E W W E E W W E W W W W W E W W E E W W W
W W W W E I E W W E W W E W W W I W W W W W E W W W E I W W
W E E C E W E W W E W W E W W W E W W W W W E W W W W E W W
W E W W W W W E E E W E E W W W I W W W W W I E E E W E W W
W E W W W W W E W W W E W W W W E E C E E W W W W I W E W W
W C W W W W W C W W W E W W W W W W W W E W W W W E W E W W
W E E E E E W E W W E E W W W W W W W W E W W W W E W E W W
W E W W W E W E W W E W W W W W W W W W E W W E E E W E W W
W I W W W E W E W W W W E E E I E E E E E W W E W W W E W W
B E E E W E W E W W W W E W W W W W W W W W W E W W W E W W
W W W C W E E E W W W W E W W W W W W W W W W E W W W E E W
W W E E W W W W W W E E E W W W E E E E E E W E W W W W E W
W W I W W W W W W W E W W W W W E W W W W E W E W W I E E W
W W E W W W W W W W E E E E E E E W W W W E E E W W W W W W
E C E W W W W W W W W W W W W W W W W W W W W W W W W W W W